DUDURDRRD
DUDURDRDR
DUDURDDRR
DUDUDRRRD
DUDUDRRDR
DUDUDRDRR
DUDUDDRRR
DUDDURRRD
DUDDURRDR
DUDDURDRR
DUDDUDRRR
DUDDRURRD
DUDDRURDR
DUDDRUDRR
DUDDRLRRR
DDUURDRRD
DDUURDRDR
DDUURDDRR
DDUUDRRRD
DDUUDRRDR
DDUUDRDRR
DDUUDDRRR
DDUDURRRD
DDUDURRDR
DDUDURDRR
DDUDUDRRR
DDUDRURRD
DDUDRURDR
DDUDRUDRR
DDUDRLRRR
