RDDDLDDRUUURRRDUDRDDRRD
RDDDLDDRUUURRRDUDRDDRDR
RDDLUDDRLURRRRDRLDDDRRR
RDLUDRLRDLRRRRLRDRDDDRR
DRUDLDDRURLRRRDDUDDRDRR
DRUDLDDRURLRRRDDUDDDRRR
DRDLDDURUUDRRRLRDRDDRRD
DRDLDDURUUDRRRLRDRDDRDR
DRDLDDURUUDRRRLRDRDDDRR
DRDLDDURUUDRRRLRDDDDRRR
DDUDDRLRDUURRRDRLDDRRRD
DDUDDRLRDUURRRDRLDDRRDR
DDUDDRLRDUURRRDRLDDRDRR
DDUDDDURDUURRRDRLRDDDRR
DDRULRLRDDURRRDRLDDRRRD
DDRULRLRDDURRRDRLDDRRDR
DDRULRLRDDURRRDRLDDRDRR
DDRULRLRDDURRRDRLDDDRRR
