RRRRDLRRRDRURRRURRRDDDRRDRDLDLUDRLRDDRRURDRDRURRRDRDURDDRRDLDDRDRURRDUDDRLDRDLLLRDLRRDDRDRRRRRURRRRRUURRDRRDRRURRRDDRDLDRDDRRUUDUULDDDDRUDLRRLDUDRRRDDRDLRLRRRDRRDRDDRURUDRRDDDRUDRUDDLURDDDRRRRDDRDLDLDLRDRDLRUUDUULURDRRDDRRDDDLDDDDDRLDUDURRDDULRURDRRURURDRRRDRLDDRDURRURDRRDLRDDRRULDRRLRLRLRLUDRRRRLRURRRDRUDRUDRRLRLRRRRUURDRDRRUDRLRRLRRRRRURDLRLRLRLUDRRRRLLRLRRRRRLRLRRRUULDDLLUDRUDLUDRLLLRRRUURUDRRRRDLURURRDRDD
RRRRDLRRRDRURRRURRRDDDRRDRDLDLUDRLRDDRRURDRDRURRRDRDURDDRRDLDDRDRURRDUDDRLDRDLLLRDLRRDDRDRRRRRURRRRRUURRDRRDRRURRRDDRDLDRDDRRUUDUULDDDDRUDLRRLDUDRRRDDRDLRLRRRDRRDRDDRURUDRRDDDRUDRUDDLURDDDRRRRDDRDLDLDLRDRDLRUUDUULURDRRDDRRDDDLDDDDDRLDUDURRDDULRURDRRURURDRRRDRLDDRDURRURDRRDLRDDRRULDRRLRLRLRLUDRRRRLRURRRDRUDRUDRRLRLRRRRUURDRDRRUDRLRRLRRRRRURDLRLRLRLUDRRRRLLRLRRRRRLRLRRRUULDDLLUDRUDLUDRLLLRRRUURUDRRRRDLURURDRRDD
RRRRDLRRRDRURRRURRRDDDRRDRDLDLUDRLRDDRRURDRDRURRRDRDURDDRRDLDDRDRURRDUDDRLDRDLLLRDLRRDDRDRRRRRURRRRRUURRDRRDRRURRRDDRDLDRDDRRUUDUULDDDDRUDLRRLDUDRRRDDRDLRLRRRDRRDRDDRURUDRRDDDRUDRUDDLURDDDRRRRDDRDLDLDLRDRDLRUUDUULURDRRDDRRDDDLDDDDDRLDUDURRDDULRURDRRURURDRRRDRLDDRDURRURDRRDLRDDRRULDRRLRLRLRLUDRRRRLRURRRDRUDRUDRRLRLRRRRUURDRDRRUDRLRRLRRRRRURDLRLRLRLUDRRRRLLRLRRRRRLRLRRRUULDDLLUDRUDLUDRLLLRRRUURUDRRRRDLURUDRRRDD
RRRRDLRRRDRURRRURRRDDDRRDRDLDLUDRLRDDRRURDRDRURRRDRDURDDRRDLDDRDRURRDUDDRLDRDLLLRDLRRDDRDRRRRRURRRRRUURRDRRDRRURRRDDRDLDRDDRRUUDUULDDDDRUDLRRLDUDRRRDDRDLRLRRRDRRDRDDRURUDRRDDDRUDRUDDLURDDDRRRRDDRDLDLDLRDRDLRUUDUULURDRRDDRRDDDLDDDDDRLDUDURRDDULRURDRRURURDRRRDRLDDRDURRURDRRDLRDDRRULDRRLRLRLRLUDRRRRLRURRRDRUDRUDRRLRLRRRRUURDRDRRUDRLRRLRRRRRURDLRLRLRLUDRRRRLLRLRRRRRLRLRRRUULDDLLUDRUDLUDRLLLRRRUURUDRRRRLDURURRDRDD
RRRRDLRRRDRURRRURRRDDDRRDRDLDLUDRLRDDRRURDRDRURRRDRDURDDRRDLDDRDRURRDUDDRLDRDLLLRDLRRDDRDRRRRRURRRRRUURRDRRDRRURRRDDRDLDRDDRRUUDUULDDDDRUDLRRLDUDRRRDDRDLRLRRRDRRDRDDRURUDRRDDDRUDRUDDLURDDDRRRRDDRDLDLDLRDRDLRUUDUULURDRRDDRRDDDLDDDDDRLDUDURRDDULRURDRRURURDRRRDRLDDRDURRURDRRDLRDDRRULDRRLRLRLRLUDRRRRLRURRRDRUDRUDRRLRLRRRRUURDRDRRUDRLRRLRRRRRURDLRLRLRLUDRRRRLLRLRRRRRLRLRRRUULDDLLUDRUDLUDRLLLRRRUURUDRRRRLDURURDRRDD
RRRRDLRRRDRURRRURRRDDDRRDRDLDLUDRLRDDRRURDRDRURRRDRDURDDRRDLDDRDRURRDUDDRLDRDLLLRDLRRDDRDRRRRRURRRRRUURRDRRDRRURRRDDRDLDRDDRRUUDUULDDDDRUDLRRLDUDRRRDDRDLRLRRRDRRDRDDRURUDRRDDDRUDRUDDLURDDDRRRRDDRDLDLDLRDRDLRUUDUULURDRRDDRRDDDLDDDDDRLDUDURRDDULRURDRRURURDRRRDRLDDRDURRURDRRDLRDDRRULDRRLRLRLRLUDRRRRLRURRRDRUDRUDRRLRLRRRRUURDRDRRUDRLRRLRRRRRURDLRLRLRLUDRRRRLLRLRRRRRLRLRRRUULDDLLUDRUDLUDRLLLRRRUURUDRRRRLDURUDRRRDD
RRRRDLRRRDRURRRURRRDDDRRDRDLDLUDRLRDDRRURDRDRURRRDRDURDDRRDLDDRDRURRDUDDRLDRDLLLRDLRRDDRDRRRRRURRRRRUURRDRRDRRURRRDDRDLDRDDRRUUDUULDDDDRUDLRRLDUDRRRDDRDLRLRRRDRRDRDDRURUDRRDDDRUDRUDDLURDDDRRRRDDRDLDLDLRDRDLRUUDUULURDRRDDRRDDDLDDDDDRLDUDURRDDULRURDRRURURDRRRDRLDDRDURRURDRRDLRDDRRULDRRLRLRLRLUDRRRRLRURRRDRUDRUDRRLRLRRRRUURDRDRRUDRLRRLRRRRRURDLRLRLLRUDRRRUDLRRLRRURDLRRRRUDRRLLLUDLUDLLUDRURDLURURUDRRRRDLURURRDRDD
RRRRDLRRRDRURRRURRRDDDRRDRDLDLUDRLRDDRRURDRDRURRRDRDURDDRRDLDDRDRURRDUDDRLDRDLLLRDLRRDDRDRRRRRURRRRRUURRDRRDRRURRRDDRDLDRDDRRUUDUULDDDDRUDLRRLDUDRRRDDRDLRLRRRDRRDRDDRURUDRRDDDRUDRUDDLURDDDRRRRDDRDLDLDLRDRDLRUUDUULURDRRDDRRDDDLDDDDDRLDUDURRDDULRURDRRURURDRRRDRLDDRDURRURDRRDLRDDRRULDRRLRLRLRLUDRRRRLRURRRDRUDRUDRRLRLRRRRUURDRDRRUDRLRRLRRRRRURDLRLRLLRUDRRRUDLRRLRRURDLRRRRUDRRLLLUDLUDLLUDRURDLURURUDRRRRDLURURDRRDD
RRRRDLRRRDRURRRURRRDDDRRDRDLDLUDRLRDDRRURDRDRURRRDRDURDDRRDLDDRDRURRDUDDRLDRDLLLRDLRRDDRDRRRRRURRRRRUURRDRRDRRURRRDDRDLDRDDRRUUDUULDDDDRUDLRRLDUDRRRDDRDLRLRRRDRRDRDDRURUDRRDDDRUDRUDDLURDDDRRRRDDRDLDLDLRDRDLRUUDUULURDRRDDRRDDDLDDDDDRLDUDURRDDULRURDRRURURDRRRDRLDDRDURRURDRRDLRDDRRULDRRLRLRLRLUDRRRRLRURRRDRUDRUDRRLRLRRRRUURDRDRRUDRLRRLRRRRRURDLRLRLLRUDRRRUDLRRLRRURDLRRRRUDRRLLLUDLUDLLUDRURDLURURUDRRRRDLURUDRRRDD
RRRRDLRRRDRURRRURRRDDDRRDRDLDLUDRLRDDRRURDRDRURRRDRDURDDRRDLDDRDRURRDUDDRLDRDLLLRDLRRDDRDRRRRRURRRRRUURRDRRDRRURRRDDRDLDRDDRRUUDUULDDDDRUDLRRLDUDRRRDDRDLRLRRRDRRDRDDRURUDRRDDDRUDRUDDLURDDDRRRRDDRDLDLDLRDRDLRUUDUULURDRRDDRRDDDLDDDDDRLDUDURRDDULRURDRRURURDRRRDRLDDRDURRURDRRDLRDDRRULDRRLRLRLRLUDRRRRLRURRRDRUDRUDRRLRLRRRRUURDRDRRUDRLRRLRRRRRURDLRLRLLRUDRRRUDLRRLRRURDLRRRRUDRRLLLUDLUDLLUDRURDLURURUDRRRRLDURURRDRDD
RRRRDLRRRDRURRRURRRDDDRRDRDLDLUDRLRDDRRURDRDRURRRDRDURDDRRDLDDRDRURRDUDDRLDRDLLLRDLRRDDRDRRRRRURRRRRUURRDRRDRRURRRDDRDLDRDDRRUUDUULDDDDRUDLRRLDUDRRRDDRDLRLRRRDRRDRDDRURUDRRDDDRUDRUDDLURDDDRRRRDDRDLDLDLRDRDLRUUDUULURDRRDDRRDDDLDDDDDRLDUDURRDDULRURDRRURURDRRRDRLDDRDURRURDRRDLRDDRRULDRRLRLRLRLUDRRRRLRURRRDRUDRUDRRLRLRRRRUURDRDRRUDRLRRLRRRRRURDLRLRLLRUDRRRUDLRRLRRURDLRRRRUDRRLLLUDLUDLLUDRURDLURURUDRRRRLDURURDRRDD
RRRRDLRRRDRURRRURRRDDDRRDRDLDLUDRLRDDRRURDRDRURRRDRDURDDRRDLDDRDRURRDUDDRLDRDLLLRDLRRDDRDRRRRRURRRRRUURRDRRDRRURRRDDRDLDRDDRRUUDUULDDDDRUDLRRLDUDRRRDDRDLRLRRRDRRDRDDRURUDRRDDDRUDRUDDLURDDDRRRRDDRDLDLDLRDRDLRUUDUULURDRRDDRRDDDLDDDDDRLDUDURRDDULRURDRRURURDRRRDRLDDRDURRURDRRDLRDDRRULDRRLRLRLRLUDRRRRLRURRRDRUDRUDRRLRLRRRRUURDRDRRUDRLRRLRRRRRURDLRLRLLRUDRRRUDLRRLRRURDLRRRRUDRRLLLUDLUDLLUDRURDLURURUDRRRRLDURUDRRRDD
RRRRDLRRRDRURRRURRRDDDRRDRDLDLUDRLRDDRRURDRDRURRRDRDURDDRRDLDDRDRURRDUDDRLDRDLLLRDLRRDDRDRRRRRURRRRRUURRDRRDRRURRRDDRDLDRDDRRUUDUULDDDDRUDLRRLDUDRRRDDRDLRLRRRDRRDRDDRURUDRRDDDRUDRUDDLURDDDRRRRDDRDLDLDLRDRDLRUUDUULURDRRDDRRDDDLDDDDDRLDUDURRDDULRURDRRURURDRRRDRLDDRDURRURDRRDLRDDRRULDRRLRLRLRLLRURULDDRRRRLLRRRRRRRURDRRRRRRURRURUURRRDLUDDRRURRRLRLURLDLRDRRDDUDLRRRLRRLRURDRRLURDLUDLUDLRRLRUDLLURURUDRRRRDLURURRDRDD
RRRRDLRRRDRURRRURRRDDDRRDRDLDLUDRLRDDRRURDRDRURRRDRDURDDRRDLDDRDRURRDUDDRLDRDLLLRDLRRDDRDRRRRRURRRRRUURRDRRDRRURRRDDRDLDRDDRRUUDUULDDDDRUDLRRLDUDRRRDDRDLRLRRRDRRDRDDRURUDRRDDDRUDRUDDLURDDDRRRRDDRDLDLDLRDRDLRUUDUULURDRRDDRRDDDLDDDDDRLDUDURRDDULRURDRRURURDRRRDRLDDRDURRURDRRDLRDDRRULDRRLRLRLRLLRURULDDRRRRLLRRRRRRRURDRRRRRRURRURUURRRDLUDDRRURRRLRLURLDLRDRRDDUDLRRRLRRLRURDRRLURDLUDLUDLRRLRUDLLURURUDRRRRDLURURDRRDD
RRRRDLRRRDRURRRURRRDDDRRDRDLDLUDRLRDDRRURDRDRURRRDRDURDDRRDLDDRDRURRDUDDRLDRDLLLRDLRRDDRDRRRRRURRRRRUURRDRRDRRURRRDDRDLDRDDRRUUDUULDDDDRUDLRRLDUDRRRDDRDLRLRRRDRRDRDDRURUDRRDDDRUDRUDDLURDDDRRRRDDRDLDLDLRDRDLRUUDUULURDRRDDRRDDDLDDDDDRLDUDURRDDULRURDRRURURDRRRDRLDDRDURRURDRRDLRDDRRULDRRLRLRLRLLRURULDDRRRRLLRRRRRRRURDRRRRRRURRURUURRRDLUDDRRURRRLRLURLDLRDRRDDUDLRRRLRRLRURDRRLURDLUDLUDLRRLRUDLLURURUDRRRRDLURUDRRRDD
RRRRDLRRRDRURRRURRRDDDRRDRDLDLUDRLRDDRRURDRDRURRRDRDURDDRRDLDDRDRURRDUDDRLDRDLLLRDLRRDDRDRRRRRURRRRRUURRDRRDRRURRRDDRDLDRDDRRUUDUULDDDDRUDLRRLDUDRRRDDRDLRLRRRDRRDRDDRURUDRRDDDRUDRUDDLURDDDRRRRDDRDLDLDLRDRDLRUUDUULURDRRDDRRDDDLDDDDDRLDUDURRDDULRURDRRURURDRRRDRLDDRDURRURDRRDLRDDRRULDRRLRLRLRLLRURULDDRRRRLLRRRRRRRURDRRRRRRURRURUURRRDLUDDRRURRRLRLURLDLRDRRDDUDLRRRLRRLRURDRRLURDLUDLUDLRRLRUDLLURURUDRRRRLDURURRDRDD
RRRRDLRRRDRURRRURRRDDDRRDRDLDLUDRLRDDRRURDRDRURRRDRDURDDRRDLDDRDRURRDUDDRLDRDLLLRDLRRDDRDRRRRRURRRRRUURRDRRDRRURRRDDRDLDRDDRRUUDUULDDDDRUDLRRLDUDRRRDDRDLRLRRRDRRDRDDRURUDRRDDDRUDRUDDLURDDDRRRRDDRDLDLDLRDRDLRUUDUULURDRRDDRRDDDLDDDDDRLDUDURRDDULRURDRRURURDRRRDRLDDRDURRURDRRDLRDDRRULDRRLRLRLRLLRURULDDRRRRLLRRRRRRRURDRRRRRRURRURUURRRDLUDDRRURRRLRLURLDLRDRRDDUDLRRRLRRLRURDRRLURDLUDLUDLRRLRUDLLURURUDRRRRLDURURDRRDD
RRRRDLRRRDRURRRURRRDDDRRDRDLDLUDRLRDDRRURDRDRURRRDRDURDDRRDLDDRDRURRDUDDRLDRDLLLRDLRRDDRDRRRRRURRRRRUURRDRRDRRURRRDDRDLDRDDRRUUDUULDDDDRUDLRRLDUDRRRDDRDLRLRRRDRRDRDDRURUDRRDDDRUDRUDDLURDDDRRRRDDRDLDLDLRDRDLRUUDUULURDRRDDRRDDDLDDDDDRLDUDURRDDULRURDRRURURDRRRDRLDDRDURRURDRRDLRDDRRULDRRLRLRLRLLRURULDDRRRRLLRRRRRRRURDRRRRRRURRURUURRRDLUDDRRURRRLRLURLDLRDRRDDUDLRRRLRRLRURDRRLURDLUDLUDLRRLRUDLLURURUDRRRRLDURUDRRRDD
