DDRDUURDRDRRRUUURRRLRRDURRDUDRRURDULRLRLLRRRRRLRLDUDDRLRRRULDDRURRDDRRRRLLUULDDDRRRRRRLDDRDRRRRDRLDRRULLDURDRDRLDRRLURRRDRRDRRLRDRLDRDLDRULDRDRRRULRRDDLDRDRRDDDDDRRLLRDLRURUDRRDRDURDDRDRRDURDDRRUDLLRDLDRDRDRDDDLDDRRDRRDRLRDRRURURDLRUURRRDRDULURRDDDLDLRRRRRRDRUDDRULRDRDLRDLLLDRDUURRDRDDDDURDDLDRRDRRLURRRDDDDLRUDRUDLULDUDRRLLRURRLDLLRRRLRUDLLUURLRRRUURRRRRLDRUDRRLUDRDDRUURRRDLLDDLRLRRRLLRRULDLUDRRRLLRLRRRRRLRRLRLRRUDLRLURRDLLRRRLULDRURDUDRRLRUDUURRDRURDRRRDRRLLRRLRLRLRRRRRLRRUDLRRRLRRR
DDRDUURDRDRRRUUURRRLRRDURRDUDRRURDULRLRLLRRRRRLRLDUDDRLRRRULDDRURRDDRRRRLLUULDDDRRRRRRLDDRDRRRRDRLDRRULLDURDRDRLDRRLURRRDRRDRRLRDRLDRDLDRULDRDRRRULRRDDLDRDRRDDDDDRRLLRDLRURUDRRDRDURDDRDRRDURDDRRUDLLRDLDRDRDRDDDLDDRRDRRDRLRDRRURURDLRUURRRDRDULURRDDDLDLRRRRRRDRUDDRULRDRDLRDLLLDRDUURRDRDDDDURDDLDRRDRRLURRRDDDDLRUDRUDLULDUDRRLLRURRLDLLRRRLRUDLLUURLRRRUURRRRRLDRUDRRLUDRDDRUURRRDLLDDLRLRRRLLRRULDLUDRRRLLRLRRRRRLRRLRLRRUDLRLURRDLLRRRLULDRURDUDRRLRUDUURRDRURDRRRDRRLLRRLRLRLRRRRRLRLRRRUDLRRRR
DDRDUURDRDRRRUUURRRLRRDURRDUDRRURDULRLRLLRRRRRLRLDUDDRLRRRULDDRURRDDRRRRLLUULDDDRRRRRRLDDRDRRRRDRLDRRULLDURDRDRLDRRLURRRDRRDRRLRDRLDRDLDRULDRDRRRULRRDDLDRDRRDDDDDRRLLRDLRURUDRRDRDURDDRDRRDURDDRRUDLLRDLDRDRDRDDDLDDRRDRRDRLRDRRURURDLRUURRRDRDULURRDDDLDLRRRRRRDRUDDRULRDRDLRDLLLDRDUURRDRDDDDURDDLDRRDRRLURRRDDDDLRUDRUDLULDUDRRLLRURRLDLLRRRLRUDLLUURLRRRUURRRRRLDRUDRRLUDRDDRUURRRDLLDDLRLRRRLLRRULDLUDRRRLLRLRRRRRLRRLRLRRUDLRLURRDLLRRRLULDRURDUDRRLRUDUURRDRURDRRDRUDRLRLRRUDUDURRDRRURDLRRUDRRR
DDRDUURDRDRRRUUURRRLRRDURRDUDRRURDULRLRLLRRRRRLRLDUDDRLRRRULDDRURRDDRRRRLLUULDDDRRRRRRLDDRDRRRRDRLDRRULLDURDRDRLDRRLURRRDRRDRRLRDRLDRDLDRULDRDRRRULRRDDLDRDRRDDDDDRRLLRDLRURUDRRDRDURDDRDRRDURDDRRUDLLRDLDRDRDRDDDLDDRRDRRDRLRDRRURURDLRUURRRDRDULURRDDDLDLRRRRRRDRUDDRULRDRDLRDLLLDRDUURRDRDDDDURDDLDRRDRRLURRRDDDDLRUDRUDLULDUDRRLLRURRLDLLRRRLRUDLLUURLRRRUURRRRRLDRUDRRLUDRDDRUURRRDLLDDLRLRRRLLRRULDLUDRRRLLRLRRRRRLRRLRLRRUDLRLURRDLLRRRLULDRURDUDRRLRUDUURRDRURDRRDRUDRLRLRRUDUDURRDRRLRRRLLRRRRR
DDRDUURDRDRRRUUURRRLRRDURRDUDRRURDULRLRLLRRRRRLRLDUDDRLRRRULDDRURRDDRRRRLLUULDDDRRRRRRLDDRDRRRRDRLDRRULLDURDRDRLDRRLURRRDRRDRRLRDRLDRDLDRULDRDRRRULRRDDLDRDRRDDDDDRRLLRDLRURUDRRDRDURDDRDRRDURDDRRUDLLRDLDRDRDRDDDLDDRRDRRDRLRDRRURURDLRUURRRDRDULURRDDDLDLRRRRRRDRUDDRULRDRDLRDLLLDRDUURRDRDDDDURDDLDRRDRRLURRRDDDDLRUDRUDLULDUDRRLLRURRLDLLRRRLRUDLLUURLRRRUURRRRRLDRUDRRLUDRDDRUURRRDLLDDLRLRRRLLRRULDLUDRRRLLRLRRRRRLRRLRLRRUDLRLURRDLLRRRLULDRURDUDRRLRUDUURRDRURDRRDRUDRLRLRRUDUDURRDRRLRLLRRRRRRR
DDRDUURDRDRRRUUURRRLRRDURRDUDRRURDULRLRLLRRRRRLRLDUDDRLRRRULDDRURRDDRRRRLLUULDDDRRRRRRLDDRDRRRRDRLDRRULLDURDRDRLDRRLURRRDRRDRRLRDRLDRDLDRULDRDRRRULRRDDLDRDRRDDDDDRRLLRDLRURUDRRDRDURDDRDRRDURDDRRUDLLRDLDRDRDRDDDLDDRRDRRDRLRDRRURURDLRUURRRDRDULURRDDDLDLRRRRRRDRUDDRULRDRDLRDLLLDRDUURRDRDDDDURDDLDRRDRRLURRRDDDDLRUDRUDLULDUDRRLLRURRLDLLRRRLRUDLLUURLRRRUURRRRRLDRUDRRLDDRRLURRDLURLRDDRLRLRRLUDLRURLLRDUDLRLRRRRRLRRLRRLRRLLUDRUDLRRURRULDDLRUDLRRRRLRRLUDRURRRUDRRRRLUDDRRRLRRRRLLRRLURDRURRLDRRR
DDRDUURDRDRRRUUURRRLRRDURRDUDRRURDULRLRLLRRRRRLRLDUDDRLRRRULDDRURRDDRRRRLLUULDDDRRRRRRLDDRDRRRRDRLDRRULLDURDRDRLDRRLURRRDRRDRRLRDRLDRDLDRULDRDRRRULRRDDLDRDRRDDDDDRRLLRDLRURUDRRDRDURDDRDRRDURDDRRUDLLRDLDRDRDRDDDLDDRRDRRDRLRDRRURURDLRUURRRDRDULURRDDDLDLRRRRRRDRUDDRULRDRDLRDLLLDRDUURRDRDDDDURDDLDRRDRRLURRRDDDDLRUDRUDLULDUDRRLLRURRLDLLRRRLRUDLLUURLRRRUURRRRRLDRUDRRLDDRRLURRDLURLRDDRLRLRRLUDLRURLLRDUDLRLRRRRRLRRLRRLRRLLUDRUDLRRURDRLLRRLURDUDRRLRRLURUDRRRUDRRRRRUDDUDLRLRURRRDLLRRRRURDLRRRR
DDRDUURDRDRRRUUURRRLRRDURRDUDRRURDULRLRLLRRRRRLRLDUDDRLRRRULDDRURRDDRRRRLLUULDDDRRRRRRLDDRDRRRRDRLDRRULLDURDRDRLDRRLURRRDRRDRRLRDRLDRDLDRULDRDRRRULRRDDLDRDRRDDDDDRRLLRDLRURUDRRDRDURDDRDRRDURDDRRUDLLRDLDRDRDRDDDLDDRRDRRDRLRDRRURURDLRUURRRDRDULURRDDDLDLRRRRRRDRUDDRULRDRDLRDLLLDRDUURRDRDDDDURDDLDRRDRRLURRRDDDDLRUDRUDLULDUDRRLLRURRLDLLRRRLRUDLLUURLRRRUURRRRRLDRUDRRLDDRRLURRDLURLRDDRLRLRRLUDLRURLLRDUDLRLRRRRRLRRLRRLRRLLUDRUDLRRURDRLLRRLURDUDRRLRRLURUDRRRUDRRRRRUDDUDLRLRURRRDLLRRRRRURLDRRR
DDRDUURDRDRRRUUURRRLRRDURRDUDRRURDULRLRLLRRRRRLRLDUDDRLRRRULDDRURRDDRRRRLLUULDDDRRRRRRLDDRDRRRRDRLDRRULLDURDRDRLDRRLURRRDRRDRRLRDRLDRDLDRULDRDRRRULRRDDLDRDRRDDDDDRRLLRDLRURUDRRDRDURDDRDRRDURDDRRUDLLRDLDRDRDRDDDLDDRRDRRDRLRDRRURURDLRUURRRDRDULURRDDDLDLRRRRRRDRUDDRULRDRDLRDLLLDRDUURRDRDDDDURDDLDRRDRRLURRRDDDDLRUDRUDLULDUDRRLLRURRLDLLRRRLRUDLLUURLRRRUURRRRRLDRUDRRLDDDURURRDULDURDDRRUDUDRRLUDULLLDLRRLRRLURDRRRUDRRLRRRUDUDRRLRRLLLRLLUDUDRRLRRRLRUDURDURRURDRRDRRRLRLRRLLRLRRURDRRRUDRRLLRRRR
DDRDUURDRDRRRUUURRRLRRDURRDUDRRURDULRLRLLRRRRRLRLDUDDRLRRRULDDRURRDDRRRRLLUULDDDRRRRRRLDDRDRRRRDRLDRRULLDURDRDRLDRRLURRRDRRDRRLRDRLDRDLDRULDRDRRRULRRDDLDRDRRDDDDDRRLLRDLRURUDRRDRDURDDRDRRDURDDRRUDLLRDLDRDRDRDDDLDDRRDRRDRLRDRRURURDLRUURRRDRDULURRDDDLDLRRRRRRDRUDDRULRDRDLRDLLLDRDUURRDRDDDDURDDLDRRDRRLURRRDDDDLRUDRUDLULDUDRRLLRURRLDLLRRRLRUDLLUURLRRRUURRRRRLDRUDRRLDDDURURRDULDURDDRRUDUDRRLUDULLLDLRRLRRLURDRRRUDRRLRRLRRRRUDLLLURDRLRLLURRDLRRRLRUDURURDRURRDURDRDUDUDRLRRURDUDRURDRRLRLRRRRR
DDRDUURDRDRRRUUURRRLRRDURRDUDRRURDULRLRLLRRRRRLRLDUDDRLRRRULDDRURRDDRRRRLLUULDDDRRRRRRLDDRDRRRRDRLDRRULLDURDRDRLDRRLURRRDRRDRRLRDRLDRDLDRULDRDRRRULRRDDLDRDRRDDDDDRRLLRDLRURUDRRDRDURDDRDRRDURDDRRUDLLRDLDRDRDRDDDLDDRRDRRDRLRDRRURURDLRUURRRDRDULURRDDDLDLRRRRRRDRUDDRULRDRDLRDLLLDRDUURRDRDDDDURDDLDRRDRRLURRRDDDDLRUDRUDLULDUDRRLLRURRLDLLRRRLRUDLLUURLRRRUURRRRRLDRUDRRLDDDURURRDULDURDDRRUDUDRRLUDULLLDLRRLRRLURDRRRUDRRLRRLRRRRUDLLLURDRLRLLURRDLRRRLRUDURURDRURDRRRRRDLLRLRLRRURRRDRRLUDRLRRLRRRR
DDRDUURDRDRRRUUURRRLRRDURRDUDRRURDULRLRLLRRRRRLRLDUDDRLRRRULDDRURRDDRRRRLLUULDDDRRRRRRLDDRDRRRRDRLDRRULLDURDRDRLDRRLURRRDRRDRRLRDRLDRDLDRULDRDRRRULRRDDLDRDRRDDDDDRRLLRDLRURUDRRDRDURDDRDRRDURDDRRUDLLRDLDRDRDRDDDLDDRRDRRDRLRDRRURURDLRUURRRDRDULURRDDDLDLRRRRRRDRUDDRULRDRDLRDLLLDRDUURRDRDDDDURDDLDRRDRRLURRRDDDDLRUDRUDLULDUDRRLLRURRLDLLRRRLRUDLLUURLRRRUURRRRRLDRUDRRLDDDURURRDULDURDDRRUDUDRRLUDULLLDLRRLRRLURDRRRUDRRLRRLRRRRUDLLLURDRLRLLURRDLRRRLRUDURURDRURDRRRDRLUDRRUDRRRLRUDRULRRDRLLRRRRR
