RDDDRUDLDUURRRDDUDRDRRD
RDDDRUDLDUURRRDDUDRDDRR
RDDDRUDLDUURRRDDUDDRDRR
RLRDLDDRDUURRRDUDDDRRRD
RLRDLDDRDUURRRDUDDDRDRR
RLRDLDDRDUURRRLRDDRDRRD
RLRDLDDRDUURRRLRDDRDRDR
DUDDDRRLDUURRRDDURDDRRD
DUDDDRRLDUURRRDDURDDRDR
DUDDDRRLDUURRRLRDRDDDRR
DRDULDDRDUURRRDDURDDRDR
DRDULDDRDUURRRDDUDDDRRR
DRDULDDRDUURRRLRDDRDRRD
DRDULDDRDUURRRLRDDRDDRR
DRDULDDRDUURRRLRDDDDRRR
DRLRLDDRDUURRRDUDDDRRRD
DRLRLDDRDUURRRDUDDDRRDR
DRLRLDDRDUURRRDUDDDDRRR
DRLRLDDRDUURRRDDURDDRRD
DRLRLDDRDUURRRDDURDDRDR
DRLRLDDRDUURRRDDUDRDDRR
DRLRLDDRDUURRRDDUDDDRRR
