RRLDLRLRDRLRRRDUDDRDDRR
RRLDLRLRDRLRRRDDUDDRRRD
RRLDLRLRDRLRRRDDUDDRRDR
RRLDLRLRDRLRRRDDUDDRDRR
RRLDLRLRDRLRRRDDUDDDRRR
RRLDLRLRDRLRRRLRDRDDRRD
RRLDLRLRDRLRRRLRDRDDRDR
RRLDLRLRDRLRRRLRDRDDDRR
RDDLDRLRUUDRRRLRDDDDRRR
RDLDUUDRDLRRRRDRLDRDRRD
RDLDUUDRDLRRRRDRLDRDRDR
RDLDUUDRDLRRRRDDUDDRDRR
RDLDUUDRDLRRRRDDUDDDRRR
RDLDDRLRLRURRRDDUDRDDRR
RDLDDRLRLRURRRLRDRDDRRD
RDLDDRLRLRURRRLRDRDDRDR
RDLDDRLRLRURRRLRDRDDDRR
RDLDDRLRLRURRRLRDDRDDRR
DUDDDUURDLRRRRDDURDDDRR
DDRDLRRLURLRRRDDUDRDRRD
DDRDLRRLURLRRRDDUDRDRDR
DDRDLRRLURLRRRDDUDRDDRR
DDDUUDURDDURRRDRLDDRRRD
DDDUUDURDDURRRDRLDDRRDR
DDDUUDURDDURRRDRLDDRDRR
