3000000000000000000000000000000000000000000000000000000000000000000000000000000000000000000000000000000000000000000000000000000000000
0000000000000000000000000000000000000000000000000000000000000000000000000000000000000000000000000000000000000000000000000000000000000
0000000000000000000000000000000000000000000000000000000000000111111110000000000000000000000000000000000000000000000000000000000000000
0000000000000000000000000000000000000000000000000000000000001111111111000000000000000000000000000000000000000000000000000000000000000
0000000000000000000000000000000000000000000000000000000000011111111111100000000000000000000000000000000000000000000000000000000000000
0000000000000000000000000000000000000000000000000000000000111111111111110000000000000000000000000000000000000000000000000000000000000
0000000000000000000000000000000000000000000000000000000001111111111111111000000000000000000000000000000000000000000000000000000000000
0000000000000000000111111111111111111111111111111111111111111111111111111111111111111111111111111111111111111111000000000000000000000
0000000000000000011111111111111111111111111111111111111111111111111111111111111111111111111111111111111111111111110000000000000000000
0000000000000000111111111111111111111111111111111111111111111111111111111111111111111111111111111111111111111111111000000000000000000
0000000000000001111111111111111111111111111111111111111111111111001111111111111111111111111111111111111111111111111100000000000000000
0000000000000001111111111111111111111111111111111111111111110000000000111111111111111111111111111111111111111111111100000000000000000
0000000000000001111111111111000000000000000000000000000000000000000000000000000000000000000000000000000111111111111100000000000000000
0000000000000001111111111111000000000000000000000000000000000000000000000000000000000000000000000000000111111111111100000000000000000
0000000000000001111111111111000000000000000000000000000000000000000000000000000000000000000000000000000111111111111100000000000000000
0000000000000001111111111111000000000000000000000000000000000000000000000000000001111110000000000000000111111111111100000000000000000
0000000000000001111111111111000000000000000000000000000000000000000000000000000111111100000000000000000111111111111100000000000000000
0000000000000001111111111111000000000000000000000000000000000000000000000000011111110000000000000000000111111111111100000000000000000
0000000000000001111111111111000000000000011111111111111111111000000000000011111110000000000000000000000111111111111100000000000000000
0000000000000001111111111111000000000000011111111111111111111000000000001111111000000000000000000000000111111111111100000000000000000
0000000000000001111111111111000000000000011111111111111111111000000000000011111110000000000000000000000111111111111100000000000000000
0000000000000000000000000000000000000000000000000000000000000000000000000000111111100000000000000000000000000000000000000000000000000
0000000000000000000000000000000000000000000000000000000000000000000000000000001111111000000000000000000000000000000000000000000000000
0000000000000001111111111111000000000000000000000000000000000000000000000000000011111110000000000000000111111111111100000000000000000
0000000000000001111111111111000000000000000000000000000000000000000000000000000000000000000000000000000111111111111100000000000000000
0000000000000001111111111111000000000000000000000000000000000000000000000000000000000000000000000000000111111111111100000000000000000
0000000000000001111111111111000000000000000000000000000000000000000000000000000000000000000000000000000111111111111100000000000000000
0000000000000001111111111111000000000000000000000000000000000000000000000000000000000000000000000000000111111111111100000000000000000
0000000000000001111111111111000000000000000000111000000000000000000000000000000000111000000000000000000111111111111100000000000000000
0000000000000001111111111111000000000000000000111111111100000000000000000001111111111000000000000000000111111111111100000000000000000
0000000000000001111111111111000000000000000000011111111111111111111111111111111111110000000000000000000111111111111100000000000000000
0000000000000001111111111111000000000000000000000001111111111111111111111111111100000000000000000000000111111111111100000000000000000
0000000000000001111111111111000000000000000000000000000000011111111111100000000000000000000000000000000111111111111100000000000000000
0000000000000001111111111111000000000000000000000000000000000000000000000000000000000000000000000000000111111111111100000000000000000
0000000000000001111111111111000000000000000000000000000000000000000000000000000000000000000000000000000111111111111100000000000000000
0000000000000001111111111111000000000000000000000000000000000000000000000000000000000000000000000000000111111111111100000000000000000
0000000000000001111111111111000000000000000000000000000000000000000000000000000000000000000000000000000111111111111100000000000000000
0000000000000001111111111111111111111111111111111111111111111111111111111111111111111111111111111111111111111111111100000000000000000
0000000000000001111111111111111111111111111111111111111111111111111111111111111111111111111111111111111111111111111100000000000000000
0000000000000000111111111111111111111111111111111111111111111111111111111111111111111111111111111111111111111111111000000000000000000
0000000000000000011111111111111111111111111111111111111111111111111111111111111111111111111111111111111111111111110000000000000000000
0000000000000000000111111111111111111111111111111111111111111111111111111111111111111111111111111111111111111111000000000000000000000
0000000000000000000000000011111111111111111111111111111111111111111111111111111111111111111111111111111110000000000000000000000000000
0000000000000000000000000000000001111111111111111111111100000000000000000000011111111111111111111111000000000000000000000000000000000
0000000000000000000000000000000111111111111111111110000000000000000000000000000000111111111111111111110000000000000000000000000000000
0000000000000000000000000000011111111111111111100000000000000000000000000000000000000111111111111111111100000000000000000000000000000
0000000000000000000000000001111111111111111110000000000000000000000000000000000000000000111111111111111111000000000000000000000000000
0000000000000000000000000011111111111111111000000000000000000000000000000000000000000000001111111111111111100000000000000000000000000
0000000000000000000000001111111111111111100000000000000000000000000000000000000000000000000011111111111111111000000000000000000000000
0000000000000000000000011111111111111110000000000000000000000000000000000000000000000000000000111111111111111100000000000000000000000
0000000000000000000001111111111111111000000000000000000000000000000000000000000000000000000000001111111111111111000000000000000000000
0000000000000000000111111111111111110000000000000000000000000000000000000000000000000000000000000111111111111111110000000000000000000
0000000000000000011111111111111111000000000000000000000000000000000000000000000000000000000000000001111111111111111100000000000000000
0000000000000001111111111111111110000000000000000000000000000000000000000000000000000000000000000000111111111111111111000000000000000
0000000000000111111111111111111000000000000000000000000000000000000000000000000000000000000000000000001111111111111111110000000000000
0000000000011111111111111111100000000000000000000000000000000000000000000000000000000000000000000000000011111111111111111100000000000
0000000011111111111111111110000000000000000000000000000000000000000000000000000000000000000000000000000000111111111111111111000000000
0000001111111111111111111000000000000000000000000000000000000000000000000000000000000000000000000000000000001111111111111111111000000
0001111111111111111111100000000000000000000000000000000000000000000000000000000000000000000000000000000000000011111111111111111111000
0000000000000000000000000000000000000000000000000000000000000000000000000000000000000000000000000000000000000000000000000000000000000
0000000000000000000000000000000000000000000000000000000000000000000000000000000000000000000000000000000000000000000000000000000000004