RRDDRLRDRRRRURRDRRRDDDDRRRDRRLRRDRDRDDDRDDRRULDDDDDRRDDRDDRUDLLRRRDUDRRRRRRDRRDRRUDRDDRLRDRDUDDRRDRURLURLDLRDLDDRULRURLRDDRDDLRRDRRRRDRRUDDRDUURUDDLRRURDDRDDDLRRRURLRUDRDDRDRRDRDUURURDLUDDRRDUULRDDDRLDDDLDRUDDUDRURDRRRRURRRDRRLRDLDUDRLRDDDURULDRRURDRURUDLRLRDDDUDDDULLLLRDDDDUDURRDR
RRDDRLRDRRRRURRDRRRDDDDRRRDRRLRRDRDRDDDRDDRRULDDDDDRRDDRDDRUDLLRRRDUDRRRRRRDRRDRRUDRDDRLRDRDUDDRRDRURLURLDLRDLDDRULRURLRDDRDDLRRDRRRRDRRUDDRDUURUDDLRRURDDRDDDLRRRURLRUDRDDRDRRDRDUURURDLUDDRRDUULRDDDRLDDDLDRUDDUDRURDRRRRURRRDRRLRDLDUDRLRDDDURULDRRURDRURUDLRLRDDDUDDDULLLLRDDDDUDUDRRR
RRDDRLRDRRRRURRDRRRDDDDRRRDRRLRRDRDRDDDRDDRRULDDDDDRRDDRDDRUDLLRRRDUDRRRRRRDRRDRRUDRDDRLRDRDUDDRRDRURLURLDLRDLDDRULRURLRDDRDDLRRDRRRRDRRUDDRDUURUDDLRRURDDRDDDLRRRURLRUDRDDRDRRDRDUURURDLUDDRRDUULRDDDRLDDDLDRUDDUDRURDRRRRURRRDRRLRDLDUDRLRDDDURULDRRURDRURUDLRLRDDDUDDDULLLLRDDDLRDURDRR
RRDDRLRDRRRRURRDRRRDDDDRRRDRRLRRDRDRDDDRDDRRULDDDDDRRDDRDDRUDLLRRRDUDRRRRRRDRRDRRUDRDDRLRDRDUDDRRDRURLURLDLRDLDDRULRURLRDDRDDLRRDRRRRDRRUDDRDUURUDDLRRURDDRDDDLRRRURLRUDRDDRDRRDRDUURURDLUDDRRDUULRDDDRLDDDLDRUDDUDRURDRRRRURRRDRRLRDLLRDRDUDUDUDRDLRRRDUURRULDUDRLDRLURDLDLLDDDDDLRDUDRRR
RRDDRLRDRRRRURRDRRRDDDDRRRDRRLRRDRDRDDDRDDRRULDDDDDRRDDRDDRUDLLRRRDUDRRRRRRDRRDRRUDRDDRLRDRDUDDRRDRURLURLDLRDLDDRULRURLRDDRDDLRRDRRRRDRRUDDRDUURUDDLRRURDDRDDDLRRRURLRUDRDDRDRRDRDUURURDLUDDRRDUULRDDDRLDDDLDRUDDUDRURDRRRRURRRDRRLDDULRDRDUDLRUDRDLRRRDLDDLRRRDDLRUULLRLDLURLDRDLDRDURDRR
RRDDRLRDRRRRURRDRRRDDDDRRRDRRLRRDRDRDDDRDDRRULDDDDDRRDDRDDRUDLLRRRDUDRRRRRRDRRDRRUDRDDRLRDRDUDDRRDRURLURLDLRDLDDRULRURLRDDRDDLRRDRRRRDRRUDDRDUURUDDLRRURDDRDDDLRRRURLRUDRDDRDRRDRDUURURDLUDDRRDUULRDDDRLDDDLDRUDDUDRURDRRRRURRRDRRLRDLDUDRLRDDDURULDRRURDRURUDLRLRDDDUDDDULLLLRDDDDUDURRDRLR
RRDDRLRDRRRRURRDRRRDDDDRRRDRRLRRDRDRDDDRDDRRULDDDDDRRDDRDDRUDLLRRRDUDRRRRRRDRRDRRUDRDDRLRDRDUDDRRDRURLURLDLRDLDDRULRURLRDDRDDLRRDRRRRDRRUDDRDUURUDDLRRURDDRDDDLRRRURLRUDRDDRDRRDRDUURURDLUDDRRDUULRDDDRLDDDLDRUDDUDRURDRRRRURRRDRRLRDLDUDRLRDDDURULDRRURDRURUDLRLRDDDUDDDULLLLRDDDDUDURRDLRR
RRDDRLRDRRRRURRDRRRDDDDRRRDRRLRRDRDRDDDRDDRRULDDDDDRRDDRDDRUDLLRRRDUDRRRRRRDRRDRRUDRDDRLRDRDUDDRRDRURLURLDLRDLDDRULRURLRDDRDDLRRDRRRRDRRUDDRDUURUDDLRRURDDRDDDLRRRURLRUDRDDRDRRDRDUURURDLUDDRRDUULRDDDRLDDDLDRUDDUDRURDRRRRURRRDRRLRDLDUDRLRDDDURULDRRURDRURUDLRLRDDDUDDDULLLLRDDDDUDUDRRRLR
RRDDRLRDRRRRURRDRRRDDDDRRRDRRLRRDRDRDDDRDDRRULDDDDDRRDDRDDRUDLLRRRDUDRRRRRRDRRDRRUDRDDRLRDRDUDDRRDRURLURLDLRDLDDRULRURLRDDRDDLRRDRRRRDRRUDDRDUURUDDLRRURDDRDDDLRRRURLRUDRDDRDRRDRDUURURDLUDDRRDUULRDDDRLDDDLDRUDDUDRURDRRRRURRRDRRLRDLDUDRLRDDDURULDRRURDRURUDLRLRDDDUDDDULLLLRDDDDUDUDRRLRR
RRDDRLRDRRRRURRDRRRDDDDRRRDRRLRRDRDRDDDRDDRRULDDDDDRRDDRDDRUDLLRRRDUDRRRRRRDRRDRRUDRDDRLRDRDUDDRRDRURLURLDLRDLDDRULRURLRDDRDDLRRDRRRRDRRUDDRDUURUDDLRRURDDRDDDLRRRURLRUDRDDRDRRDRDUURURDLUDDRRDUULRDDDRLDDDLDRUDDUDRURDRRRRURRRDRRLRDLDUDRLRDDDURULDRRURDRURUDLRLRDDDUDDDULLLLRDDDLRDURDRRLR
RRDDRLRDRRRRURRDRRRDDDDRRRDRRLRRDRDRDDDRDDRRULDDDDDRRDDRDDRUDLLRRRDUDRRRRRRDRRDRRUDRDDRLRDRDUDDRRDRURLURLDLRDLDDRULRURLRDDRDDLRRDRRRRDRRUDDRDUURUDDLRRURDDRDDDLRRRURLRUDRDDRDRRDRDUURURDLUDDRRDUULRDDDRLDDDLDRUDDUDRURDRRRRURRRDRRLRDLDUDRLRDDDURULDRRURDRURUDLRLRDDDUDDDULLLLRDDDLRDURDRLRR
RRDDRLRDRRRRURRDRRRDDDDRRRDRRLRRDRDRDDDRDDRRULDDDDDRRDDRDDRUDLLRRRDUDRRRRRRDRRDRRUDRDDRLRDRDUDDRRDRURLURLDLRDLDDRULRURLRDDRDDLRRDRRRRDRRUDDRDUURUDDLRRURDDRDDDLRRRURLRUDRDDRDRRDRDUURURDLUDDRRDUULRDDDRLDDDLDRUDDUDRURDRRRRURRRDRRLRDLLRDRDUDUDUDRDLRRRDUURRULDUDRLDRLURDLDLLDDDDDLRDUDRRRLR
RRDDRLRDRRRRURRDRRRDDDDRRRDRRLRRDRDRDDDRDDRRULDDDDDRRDDRDDRUDLLRRRDUDRRRRRRDRRDRRUDRDDRLRDRDUDDRRDRURLURLDLRDLDDRULRURLRDDRDDLRRDRRRRDRRUDDRDUURUDDLRRURDDRDDDLRRRURLRUDRDDRDRRDRDUURURDLUDDRRDUULRDDDRLDDDLDRUDDUDRURDRRRRURRRDRRLRDLLRDRDUDUDUDRDLRRRDUURRULDUDRLDRLURDLDLLDDDDDLRDUDRRLRR
RRDDRLRDRRRRURRDRRRDDDDRRRDRRLRRDRDRDDDRDDRRULDDDDDRRDDRDDRUDLLRRRDUDRRRRRRDRRDRRUDRDDRLRDRDUDDRRDRURLURLDLRDLDDRULRURLRDDRDDLRRDRRRRDRRUDDRDUURUDDLRRURDDRDDDLRRRURLRUDRDDRDRRDRDUURURDLUDDRRDUULRDDDRLDDDLDRUDDUDRURDRRRRURRRDRRLDDULRDRDUDLRUDRDLRRRDLDDLRRRDDLRUULLRLDLURLDRDLDRDURDRRLR
RRDDRLRDRRRRURRDRRRDDDDRRRDRRLRRDRDRDDDRDDRRULDDDDDRRDDRDDRUDLLRRRDUDRRRRRRDRRDRRUDRDDRLRDRDUDDRRDRURLURLDLRDLDDRULRURLRDDRDDLRRDRRRRDRRUDDRDUURUDDLRRURDDRDDDLRRRURLRUDRDDRDRRDRDUURURDLUDDRRDUULRDDDRLDDDLDRUDDUDRURDRRRRURRRDRRLDDULRDRDUDLRUDRDLRRRDLDDLRRRDDLRUULLRLDLURLDRDLDRDURDRLRR
