R L R D L D U R D L R R R R D R L R D D R D R
R L R D L D U R D L R R R R D R L R D D D R R
R L R D L D U R D L R R R R D R L D R D R R D
R L R D L D U R D L R R R R D R L D R D R D R
R L R D L D U R D L R R R R D R L D R D D R R
R L R D L D U R D L R R R R D R L D D R R R D
R L R D L D U R D L R R R R D R L D D R R D R
R L R D L D U R D L R R R R D R L D D R D R R
R L R D L D U R D L R R R R D R L D D D R R R
R L R D L D U R D L R R R R D D U R D D R R D
R L R D L D U R D L R R R R D D U R D D R D R
R L R D L D U R D L R R R R D D U R D D D R R
R L R D L D U R D L R R R R D D U D R D R R D
R L R D L D U R D L R R R R D D U D R D R D R
R L R D L D U R D L R R R R D D U D R D D R R
R L R D L D U R D L R R R R D D U D D R R R D
R L R D L D U R D L R R R R D D U D D R R D R
R L R D L D U R D L R R R R D D U D D R D R R
R L R D L D U R D L R R R R D D U D D D R R R
R L R D L D U R D L R R R R L R D R D D R R D
R L R D L D U R D L R R R R L R D R D D R D R
R L R D L D U R D L R R R R L R D R D D D R R
R L R D L D U R D L R R R R L R D D R D R R D
R L R D L D U R D L R R R R L R D D R D R D R
R L R D L D U R D L R R R R L R D D R D D R R
R L R D L D U R D L R R R R L R D D D R R R D
R L R D L D U R D L R R R R L R D D D R R D R
R L R D L D U R D L R R R R L R D D D R D R R
R L R D L D U R D L R R R R L R D D D D R R R
R L R D L D U R L R D R R R D U D R D D R R D