D U D U R D R R D
D U D U R D R D R
D U D U R D D R R
D U D U D R R R D
D U D U D R R D R
D U D U D R D R R
D U D U D D R R R
D U D D U R R R D
D U D D U R R D R
D U D D U R D R R
D U D D U D R R R
D U D D R U R R D
D U D D R U R D R
D U D D R U D R R
D U D D R L R R R
D D U U R D R R D
D D U U R D R D R
D D U U R D D R R
D D U U D R R R D
D D U U D R R D R
D D U U D R D R R
D D U U D D R R R
D D U D U R R R D
D D U D U R R D R
D D U D U R D R R
D D U D U D R R R
D D U D R U R R D
D D U D R U R D R
D D U D R U D R R
D D U D R L R R R