DURDDRDRDDRRRDRRDRRRRLRRRDRRRUDRDRDRDDDRDRDRULDDDRDDRLDUDDRURRDDRDUDRDRRRRRDDRRRURDRDDRLRRDLRDDRRDRDLRDLDLDLLURDDLULDDRRRDRLLRDRUURLRRDLURDRDRDLDDDRDLLUDRRDDLLDDDRDRRDDRRRRRDRURURURLDLRRULDRRRUDDRDLRRDDDRDLDRURRRDRLDRRRLRDURRRRRRUDDLURDRUUURRLUURDRDUDDURLUDRDDDLDRRURUUDDRDDDUDUDRRR
DURDDRDRDDRRRDRRDRRRRLRRRDRRRUDRDRDRDDDRDRDRULDDDRDDRLDUDDRURRDDRDUDRDRRRRRDDRRRURDRDDRLRRDLRDDRRDRDLRDLDLDLLURDDLULDDRRRDRLLRDRUURLRRDLURDRDRDLDDDRDLLUDRRDDLLDDDRDRRDDRRRRRDRURURURLDLRRULDRRRUDDRDLRRDDDRDLDRURRRDRLDRRRLRDURRRRRRUDDLURDRUUURRLUURDRDUDDURLUDRDDDLDRRURLURRDDDDUDURDRR
DURDDRDRDDRRRDRRDRRRRLRRRDRRRUDRDRDRDDDRDRDRULDDDRDDRLDUDDRURRDDRDUDRDRRRRRDDRRRURDRDDRLRRDLRDDRRDRDLRDLDLDLLURDDLULDDRRRDRLLRDRUURLRRDLURDRDRDLDDDRDLLUDRRDDLLDDDRDRRDDRRRRRDRURURURLDLRRULDRRRUDDRDLRRDDDRDLDRURRRDRLDRRRLRDURRRRRRUDDLURDRUUURRLUURDRDUDDRRLULRDDDLRDURRUUDDRDDLRDURDRR
DURDDRDRDDRRRDRRDRRRRLRRRDRRRUDRDRDRDDDRDRDRULDDDRDDRLDUDDRURRDDRDUDRDRRRRRDDRRRURDRDDRLRRDLRDDRRDRDLRDLDLDLLURDDLULDDRRRDRLLRDRUURLRRDLURDRDRDLDDDRDLLUDRRDDLLDDDRDRRDDRRRRRDRURURURLDLRRULDRRRUDDRDLRRDDDRDLDRURRRDRLDRRRLRDURRRRRRUDDLURDRUUURRLUURDRDUDDRRLULRDDDLRDURRUUDDRDDLRDUDRRR
DURDDRDRDDRRRDRRDRRRRLRRRDRRRUDRDRDRDDDRDRDRULDDDRDDRLDUDDRURRDDRDUDRDRRRRRDDRRRURDRDDRLRRDLRDDRRDRDLRDLDLDLLURDDLULDDRRRDRLLRDRUURLRRDLURDRDRDLDDDRDLLUDRRDDLLDDDRDRRDDRRRRRDRURURURLDLRRULDRRRUDDRDLRRDDDRDLDRURRRDRLDRRRLRDURRRRRRUDDLURDRUUURRLUURDRDUDDRRLULRDDDLRDRURURUDDDDDUDURDRR
DURDDRDRDDRRRDRRDRRRRLRRRDRRRUDRDRDRDDDRDRDRULDDDRDDRLDUDDRURRDDRDUDRDRRRRRDDRRRURDRDDRLRRDLRDDRRDRDLRDLDLDLLURDDLULDDRRRDRLLRDRUURLRRDLURDRDRDLDDDRDLLUDRRDDLLDDDRDRRDDRRRRRDRURURURLDLRRULDRRRUDDRDLRRDDDRDLDRURRRDRLDRRRLRDURRRRRRUDDLURDRUUURLUURRDRDUULDDRRLRDDDLRDRURLRURDDLDRDUDRRR
DURDDRDRDDRRRDRRDRRRRLRRRDRRRUDRDRDRDDDRDRDRULDDDRDDRLDUDDRURRDDRDUDRDRRRRRDDRRRURDRDDRLRRDLRDDRRDRDLRDLDLDLLURDDLULDDRRRDRLLRDRUURLRRDLURDRDRDLDDDRDLLUDRRDDLLDDDRDRRDDRRRRRDRURURURLDLRRULDRRRUDDRDLRRDDDRDLDRURRRDRLDRRRLRDURRRRRRUDDLUDRULUUURURRRDRRDLDRURLDUDDDLRDURRUDUDRDDDUDUDRRR
DURDDRDRDDRRRDRRDRRRRLRRRDRRRUDRDRDRDDDRDRDRULDDDRDDRLDUDDRURRDDRDUDRDRRRRRDDRRRURDRDDRLRRDLRDDRRDRDLRDLDLDLLURDDLULDDRRRDRLLRDRUURLRRDLURDRDRDLDDDRDLLUDRRDDLLDDDRDRRDDRRRRRDRURURURLDLRRULDRRRUDDRDLRRDDDRDLDRURRRDRLDRRRLRDURRRRRRUDDLUDRULUUURURRDRRRLDLRUDUDRDDDLDRRURULRRDDDDUDURDRR
DURDDRDRDDRRRDRRDRRRRLRRRDRRRUDRDRDRDDDRDRDRULDDDRDDRLDUDDRURRDDRDUDRDRRRRRDDRRRURDRDDRLRRDLRDDRRDRDLRDLDLDLLURDDLULDDRRRDRLLRDRUURLRRDLURDRDRDLDDDRDLLUDRRDDLLDDDRDRRDDRRRRRDRURURURLDLRRULDRRRUDDRDLRRDDDRDLDRURRRDRLDRRRLRDURRRRRRUDLUDDRRUUURRLUUDRRDRLLRLUDRRDDDLDRURRULRDRDDLRDURDRR
DURDDRDRDDRRRDRRDRRRRLRRRDRRRUDRDRDRDDDRDRDRULDDDRDDRLDUDDRURRDDRDUDRDRRRRRDDRRRURDRDDRLRRDLRDDRRDRDLRDLDLDLLURDDLULDDRRRDRLLRDRUURLRRDLURDRDRDLDDDRDLLUDRRDDLLDDDRDRRDDRRRRRDRURURLURDLRRLUDDDRRURDRLRRDDDRDLDDRRRRDUDURRRLDRURRRRRRUDLDRDUUUURRULRURDRRLULDDRRDUDDDLRDURRRULRDDDLRDUDRRR
DURDDRDRDDRRRDRRDRRRRLRRRDRRRUDRDRDRDDDRDRDRULDDDRDDRLDUDDRURRDDRDUDRDRRRRRDDRRRURDRDDRLRRDLRDDRRDRDLRDLDLDLLURDDLULDDRRRDRLLRDRUURLRRDLURDRDRDLDDDRDLLUDRRDDLLDDDRDRRDDRRRRRLRRRUDRLRULRRUURRRDLDDDRLRRDDDDRLDDRRRRDLRURRRLRUDRRRRRRUDDLRDUUUUULRRRUDRLDUURDRDLRRDDDLRDRURUDURDDLDRDURDRR
DURDDRDRDDRRRDRRDRRRRLRRRDRRRUDRDRDRDDDRDRDRULDDDRDDRLDUDDRURRDDRDUDRDRRRRRDDRRRURDRDDRLRRDLRDDRRDRDLRDLDLDLLURDDLULDDRRRDRLLRDRUURLRRDLURDRDRDLDDDRDLLUDRRDDLLDDDRDRRDDRRRRRLRRRUDRLRULRRUURRRDLDDDRLRRDDDDRLDDRRRRDLRURRRLRUDRRRRRRUDLUDDRUULUURRURDRRDUDDRUDUDUDDDLRDRURRLURDDDLRDUDRRR
DURDDRDRDDRRRDRRDRRRRLRRRDRRRUDRDRDRDDDRDRDRULDDDRDDRLDUDDRURRDDRDUDRDRRRRRDDRRRURDRDDRLRRDLRDDRRDRDLRDLDLDLLURDDLULDDRRRDRLLRDRUURLRRDLURDRDRDLDDDRDLLUDRRDDLLDDDRDRRDDRRRRRLRRRUDRLRULRRUURRRDLDDDRLRRDDDDRLDDRRRRDLRURRRLRUDRRRRRRUDLUDDRUULUURRURDRRDUDDRULUDRDDDLRDURRUDUDRDDLRDURRDR
DURDDRDRDDRRRDRRDRRRRLRRRDRRRUDRDRDRDDDRDRDRULDDDRDDRLDUDDRURRDDRDUDRDRRRRRDDRRRURDRDDRLRRDLRDDRRDRDLRDLDLDLLURDDLULDDRRRDRLLRDRUURLRRDLURDRDRDLDDDRDLLUDRRDDLLDDDRDRRDDRRRRRLRRRUDRLRULRRUURRRDLDDDRLRRDDDDRLDDRRRRDLRURRRLRUDRRRRRRUDLUDDRUULUURRURDRRDUDDRULUDRDDDLRDURRRULRDDDDUDURDRR
DURDDRDRDDRRRDRRDRRRRLRRRDRRRUDRDRDRDDDRDRDRULDDDRDDRLDUDDRURRDDRDUDRDRRRRRDDRRRURDRDDRLRRDLRDDRRDRDLRDLDLDLLURDDLULDDRRRDRLLRDRUURLRRDLURDRDRDLDDDRDLLUDRRDDLLDDDRDRRDDRRRRRLRRRUDRLRULRRUURRRDLDDDRLRRDDDDRLDDRRRRDLRURRRLRUDRRRRRRUDLUDDRUULUURRURDRRDRLLDUUDRRDDDLRDRURUUDDRDDLRDUDRRR
DURDDRDRDDRRRDRRDRRRRLRRRDRRRUDRDRDRDDDRDRDRULDDDRDDRLDUDDRURRDDRDUDRDRRRRRDDRRRURDRDDRLRRDLRDDRRDRDLRDLDLDLLURDDLULDDRRRDRLLRDRUURLRRDLURDRDRDLDDDRDLLUDRRDDLLDDDRDRRDDRRRRRLRRLUDRRRULRRLUDRRRUDDUDDRRURDDRLRDDDRRLRDDRRRLURDRRRRRRUDDLURDUUURRULURDRLUDUDRRDLRRDDDLRDRURRULRDDDDUDURDRR
DURDDRDRDDRRRDRRDRRRRLRRRDRRRUDRDRDRDDDRDRDRULDDDRDDRLDUDDRURRDDRDUDRDRRRRRDDRRRURDRDDRLRRDLRDDRRDRDLRDLDLDLLURDDLULDDRRRDRLLRDRUURLRRDLURDRDRDLDDDRDLLUDRRDDLLDDDRDRRDDRRRRRLRRLUDRRRULRRLUDRRRUDDUDDRRURDDRLRDDDRRLRDDRRRLURDRRRRRRUDDLRUDUURURLUURRDRRLDDLUUDRRDDDLRDURRUUDDRDDDUDURDRR
DURDDRDRDDRRRDRRDRRRRLRRRDRRRUDRDRDRDDDRDRDRULDDDRDDRLDUDDRURRDDRDUDRDRRRRRDDRRRURDRDDRLRRDLRDDRRDRDLRDLDLDLLURDDLULDDRRRDRLLRDRUURLRRDLURDRDRDLDDDRDLLUDRRDDLLDDDRDRRDDRRRRRLRRLUDRRRULRRLUDRRRUDDUDDRRURDDRLRDDDRRLRDDRRRLURDRRRRRRUDDLRUDUURURLUURRDRRLDDLUUDRRDDDLRDURRUUDDRDDLRDUDRRR
DURDDRDRDDRRRDRRDRRRRLRRRDRRRUDRDRDRDDDRDRDRULDDDRDDRLDUDDRURRDDRDUDRDRRRRRDDRRRURDRDDRLRRDLRDDRRDRDLRDLDLDLLURDDLULDDRRRDRLLRDRUURLRRDLURDRDRDLDDDRDLLUDRRDDLLDDDRDRRDDRRRRRLRRLUDRRRULRRLUDRRRUDDUDDRRURDDRLRDDDRRLRDDRRRLURDRRRRRRUDLDURDUURURUDUUDRRRLDLRRDUDUDDDLRDURRRLURDDDDUDURRDR
